########
#      #
#  #   #
#      #
########
