''..............############################################
................#'''''%''''''''''''''%''''''''''''%''''''''#
................#'''''%''''''''''''''%''''''''''''%''''''''#
................#'''''%''''''''''''''%''''''E'''''%''''''''#
................#'''''%''''''''''''''%''''''''''''%''''''''#
................#'''''%''''''''''''''%''''''''''''%''''''''#
................#'''''%''''''''''''''%'''%%%%%%%%%%''''''''#
................#''''''''''''''''''''%'''%''''''''%''''''''#
................#''''''''''''''''''''%'''%''''''''%''''''''#
................#'''''%''''''''''''''%'''%''''''''%''''''''#
................#'''''%''''''''''''''%'''%''''''''%''''''''#
................#'''''%''''''''''''''%'''%''''''''%''''''''#
...##############%%%%%%''''%%%%%%%%%%%'''%%%''''%%%''''''''#
...#'''''''''''''''''''''''''''''''''''''''''''''''''''''''#
...#'''''''''''''''''''''''''''''''''''''''''''''''''''''''#
...#'''''''''''''''''''''''''''''''''''''''''''''''''''''''#
...#'''''''''''''''''''''''''''''''''''''''''''''''''''''''#
...#'''''''''''''''''''''''''''''''''''''''''''''''''''''''#
...#''''''''''''%%%%%%%%%%%%'''''%%%%%'''%%%%%%%%%%%%%%%%%%#
...#''''''''''''%''''''''''%'''''%'''''''''''''''''''''''''#
...#''''''''''''%''''''''''%'''''%'''''''''''''''''''''''''#
...#''''''''''''%''''''''''%'''''%'''''''''''''''''''''''''#
...#''''''''''''%''''''''''%'''''%'''''''''''''''''''''''''#
...#''''''''''''%''''''''''%'''''%'''''''''''''''''''''''''#
####%%%%%%%%%%%%%'''''E''''%'''''%'''''''''''''''''''''''''#
#'''''''''''''''%''''''''''%'''''%'''''''''''''''''''''''''#
#'''''''''''''''%''''''''''%'''''%'''''''''''''''''''''''''#
#'''''''''''''''%''''''''''%'''''%'''''''''''''''''''''''''#
#'''''''''''''''%''''''''''%'''''%'''''''''''''''''''''''''#
#'''''''''''''''%''''''''''%'''''%'''''''''''''''''''''''''#
#''''''''''''''''''''''''''''''''''''''''''''''''''''''''''#
#''''''''''''''''''''''''''''''''''''''''''''''''''''''''''#
#''''''''''''''''''''''''''''''''''''''''''''''''''''''''''#
#''''''''''''''''''''''''''''''''''''''''''''''''''''''''''#
###################################''''''''''''''''''''''''#
..................................#''''''''''''''''''''''''#
..................................#''''''''''''''''''''''''#
..................................#''''''''''''''''''''''''#
..................................#''''''''''''''''''''''''#
..................................#''''''''''''''''''''''''#
..................................#######'''################
..................................#'''''''''#...............
..................................#'''''''''#...............
..................................#'''''''''#...............
..................................#''''E''''#...............
..................................#'''''''''#...............
..................................#'''''''''#...............
..................................###########...............
