................############################################
................#     %              %            %        #
................#     %              %            %        #
................#     %              %      E     %        #
................#     %              %            %        #
................#     %              %            %        #
................#     %              %   %%%%%%%%%%        #
................#                    %   %        %        #
................#                    %   %        %        #
................#     %              %   %        %        #
................#     %              %   %        %        #
................#     %              %   %        %        #
...##############%%%%%%    %%%%%%%%%%%   %%%    %%%        #
...#                                                       #
...#                                                       #
...#                                                       #
...#                                                       #
...#                                                       #
...#            %%%%%%%%%%%%     %%%%%   %%%%%%%%%%%%%%%%%%#
...#            %          %     %                         #
...#            %          %     %                         #
...#            %          %     %                         #
...#            %          %     %                         #
...#            %          %     %                         #
####%%%%%%%%%%%%%     E    %     %                         #
#               %          %     %                         #
#               %          %     %                         #
#               %          %     %                         #
#               %          %     %                         #
#               %          %     %                         #
#                                                          #
#                                                          #
#                                                          #
#                                                          #
###################################                        #
..................................#                        #
..................................#                        #
..................................#                        #
..................................#                        #
..................................#                        #
..................................#######   ################
..................................#         #...............
..................................#         #...............
..................................#         #...............
..................................#    E    #...............
..................................#         #...............
..................................#         #...............
..................................###########...............
