################
#       %      #
#       %      #
#       %      #
#              #
#%%%%%%%%      #
#              #
#              #
#              #
#              #
################
