##################
#       %        #
#       %        #
#       %        #
#                #
#%%%%%%%%        #
#                #
#                #
#                #
#                #
#                #
#                #
#                #
#                #
#                #
#                #
#                #
##################
